prompt	"1. 미국 라스베거스에서 진행된 2026 CES에 대해
2. 제조업체 입장에서 주요 주제는 6가지로 봤는데 각 주제에 대한 키워드는 아래와 같아: A. 초보자를 전문가로 만들어주는 Intelligent transformation; B. 현실 세계를 이해하여 인간 작업자와 함께 또는 인공지능간에 협업으로 일을 하는 Physical AI; C. Level 4 자율주행이 현실화 된 SDV; D. 실생활 예방을 중심으로 다양한 생체 시그널을 모니터링하는 디지털 헬스케어; E. AI 서비스가 증가함에 따라 요구되는 Energy와 Infrastructure; F. 신규로 개설된 Foundary 코너와 다양한 요소 장비에 Fullstack으로 들어가는 AI Infra. 
3. ~~~ 주제 아래 소주제로 ~~~에 대한 개요와 전시 트렌드 3가지 조사해줘. 그리고 인터넷이나 뉴스에서 화제가 많이 되고 있는 주요 전시 내용을 6개 선별한다음에, 각 주제별로 주요 전시 내용을 작성하고, 해당 전시 내용에 대해서 인터넷 커뮤니티에서 어떠한 평가가 이야기되고 있는지 조사해줘. 크게 만족해하는 부분과 더 개선이 필요했으면 하는 부분이 있으면 그 부분을 위주로 작성해주면 좋아. 그리고 그러한 정보를 수집한 참고 사이트의 링크도 같이 조사해줘. 링크는 뉴스기사를 선호하고 뉴스기사가 없으면 레딧과 같은 커뮤니티를 이용하면 좋아. 커뮤니티에도 정보가 없다면 ""검증 필요""로 표시해줘.
4. 조사된 주요 전시 내용들에 대해서 플라스틱 소재사 입장에서 기회가 될 수 있는 요소를 5개 제안해줘. 아래 5번 단계에서 요약하는 표에는 두 항목만 정리할 거야. 
5. 위의 내용에 대해 docx 문서로 일반 보고서 형식으로 작성한 이후에, 보고서 말미에 2열짜리 표 형식으로 보고서 내용을 요약해줘. 표 1열1행의 값은 'elements'야. 요약해야 할 내용과 양식은 다음과 같아."	
elements	출력 내용	출력 길이
Title1	입력 필요	한글 28글자 이내
Summary1	소주제에 대한 개요	한글 52글자 이내
Trend1	소주제에 대한 트렌드1	한글 65글자 이내
Trend2	소주제에 대한 트렌드2	한글 65글자 이내
Trend3	소주제에 대한 트렌드3	한글 65글자 이내
Contents1	소주제에 대한 주요 전시 내용1	한글 65글자 이내
VoC1	Contents1에 대해 인터넷 상의 반응 요약. 논란거리나 페인포인트가 있다면 그 위주로 정리	한글 65글자 이내
ref01	VoC1에 대한 참고 링크. 없으면 "검증 필요"	제한없음
Contents2	소주제에 대한 주요 전시 내용2	한글 65글자 이내
VoC2	Contents2에 대해 인터넷 상의 반응 요약. 논란거리나 페인포인트가 있다면 그 위주로 정리	한글 65글자 이내
ref02	VoC2에 대한 참고 링크. 없으면 "검증 필요"	제한없음
Contents3	소주제에 대한 주요 전시 내용3	한글 65글자 이내
VoC3	Contents3에 대해 인터넷 상의 반응 요약. 논란거리나 페인포인트가 있다면 그 위주로 정리	한글 65글자 이내
ref03	VoC3에 대한 참고 링크. 없으면 "검증 필요"	제한없음
Contents4	소주제에 대한 주요 전시 내용4	한글 65글자 이내
VoC4	Contents4에 대해 인터넷 상의 반응 요약. 논란거리나 페인포인트가 있다면 그 위주로 정리	한글 65글자 이내
ref04	VoC4에 대한 참고 링크. 없으면 "검증 필요"	제한없음
Contents5	소주제에 대한 주요 전시 내용5	한글 65글자 이내
VoC5	Contents5에 대해 인터넷 상의 반응 요약. 논란거리나 페인포인트가 있다면 그 위주로 정리	한글 65글자 이내
ref05	VoC5에 대한 참고 링크. 없으면 "검증 필요"	제한없음
Contents6	소주제에 대한 주요 전시 내용6	한글 65글자 이내
VoC6	Contents6에 대해 인터넷 상의 반응 요약. 논란거리나 페인포인트가 있다면 그 위주로 정리	한글 65글자 이내
ref06	VoC6에 대한 참고 링크. 없으면 "검증 필요"	제한없음
Insight1	플라스틱 소재사 입장에서 기회가 될 수 있는 요소1	한글 65글자 이내
Insight2	플라스틱 소재사 입장에서 기회가 될 수 있는 요소2	한글 65글자 이내
